235

ingomberare (= ingombrare) — occupare, nam occludere („platea
nou inpombereter timo“ - p. 196).

lronarlicia - vestimenti mulierum species.

lembus —- navis majoris speeies.

logya (it. leggia) - aedes aperta, xystus, porticus.

londrum = londra - naviculae species, linter.

malsonus - (rt, malsono) -· mele sanus; speciatim scabiosi haud
dubio ita nominabantur (mabam morari debeant de ioris et duobus
ex eis liceat uenire ad ciuitatem omni die dominica“ -— p. 260).

malvendula — Ni fallor mulier, quae in venditionibus ad fallendum
emptores est perata.

mansus - manzo — vitulus anniculus.

massarius — fisci communis custos3 officialis, qni erigebatur mulctas
impositas (p. 247, 249, 295).

marinare -- (it. macinare) - molere (‚‚debeet accipere amaricare
uolentibus granum in molendinis“ p. 288).

molus - (it. molo) murus in litore contra impetum maris exstructus.

monto - (it. montone) —- vervex (p. 222).

mucia -- operimentum capitis, fascia, quae caput involvitur. ⁸

nauliaare = nauligare - navem ad vecturam conducere.

naulum -— rectior) — merces, quae a vectore solvitur ei, qui navem
exercet of. et. gloss. vol. 1. s. h. v.

panceria —- (it. pauciora) - lorica.

pancogolc - caupo, vel qui meme excipit. (Nisi idem ac pani·
cocola putes.)

panicocola — furnarius („teneantur inquirere paciscendae, si faciunt
panem iuxta pondus“ ·- p. 243).

paterenus - haereticus.

platearins (placarius) — tributi exactor3 custos etiam civitatis, cujus
erat citare accusatos („citatio fiat per noenum seu platearium“

protensum >- umbella.

quelquatia - panni canabini.

rauoliosus - rabiosus.

nivarius —- custos ripee; dein generaliter custos civitatis. — cf. et.
plateariccs.

robaria - spoliatio.

rogancia - mandatum; etiam res, quae alicui deta est, ut rem in
certum locum transferat („si aliquis. ..dederit ropanciam alicui,
et ipse. . . fuerit derobatus et perdiderit roganciam“ —- p. 221).

roncinns = runcinus - equus minor, gregarius.

salmerius -— equus sarcinarios.

salpe (χρυσόπλευρος) piscis genus.

salquaticum - tributum pro sale empto solvendum.

sertia - cannabis, unde funes nautici parantur,

sarcis (- seruilis) - panni species („portauerint clamidem sarcis
nigre“ - p. 294).

saraa = sancus -— rudens.

 

